{
  "Name": "Aquecimento",
  "Id": 1,
  "Width": 7, "Height": 4, "Depth": 7,
  "Players": [
    [2, 3, 5]
  ],
  "Boxes": [
    [1, 1, 3, "Heavy"],
    [5, 1, 5, "Permanent"],
    [2, 1, 3, "Heavy"],
    [3, 1, 3, "Heavy"]
  ],
  "Objectives": [
    [3, 1, 1]
  ],
  "Enemies": [],
  "Obstacles": [
    [0, 0, 0],
    [0, 0, 1],
    [0, 0, 2],
    [0, 0, 3],
    [0, 0, 4],
    [0, 0, 5],
    [0, 0, 6],
    [1, 0, 0],
    [1, 0, 1],
    [1, 0, 2],
    [1, 0, 3],
    [1, 0, 4],
    [1, 0, 5],
    [1, 0, 6],
    [2, 0, 0],
    [2, 0, 1],
    [2, 0, 2],
    [2, 0, 3],
    [2, 0, 4],
    [2, 0, 5],
    [2, 0, 6],
    [3, 0, 0],
    [3, 0, 1],
    [3, 0, 2],
    [3, 0, 3],
    [3, 0, 4],
    [3, 0, 5],
    [3, 0, 6],
    [4, 0, 0],
    [4, 0, 1],
    [4, 0, 2],
    [4, 0, 3],
    [4, 0, 4],
    [4, 0, 5],
    [4, 0, 6],
    [5, 0, 0],
    [5, 0, 1],
    [5, 0, 2],
    [5, 0, 3],
    [5, 0, 4],
    [5, 0, 5],
    [5, 0, 6],
    [6, 0, 0],
    [6, 0, 1],
    [6, 0, 2],
    [6, 0, 3],
    [6, 0, 4],
    [6, 0, 5],
    [6, 0, 6],
    [3, 1, 5],
    [0, 1, 6],
    [0, 1, 5],
    [0, 1, 4],
    [0, 1, 3],
    [0, 1, 2],
    [0, 1, 1],
    [0, 1, 0],
    [1, 1, 0],
    [2, 1, 0],
    [3, 1, 0],
    [4, 1, 0],
    [5, 1, 0],
    [6, 1, 0],
    [6, 1, 1],
    [6, 1, 2],
    [6, 1, 3],
    [6, 1, 4],
    [6, 1, 5],
    [6, 1, 6],
    [5, 1, 6],
    [4, 1, 6],
    [3, 1, 6],
    [2, 1, 6],
    [1, 1, 6],
    [4, 1, 3],
    [5, 1, 3]
  ],
  "Portals": [],
  "Plates": [],
  "Toggles": []
}
